District,Palika,HLCIT_CODE,CBS_Code,Total_Pop,Male_Pop,Female_Pop,Sex_Ratio
UDAYAPUR,Tapli Gaunpalika,524 1 14 4 001,11406,14562,6929,7633,90.78
SYANGJA,Phedikhola Gaunpalika,524 4 41 4 002,40902,12341,5259,7082,74.26
GORKHA,Ajirkot Gaunpalika,524 4 36 4 002,40102,15602,7165,8437,84.92
JAJARKOT,Barekot Gaunpalika,524 6 60 4 003,60701,18083,9121,8962,101.77
SIRAHA,Aurahi Gaunpalika,524 2 16 4 004,20216,23046,11116,11930,93.18
TANAHU,Aanbu Khaireni Gaunpalika,524 4 40 4 005,40710,20768,9504,11264,84.38
MANANG,Naraphu Gaunpalika,524 4 38 4 002,40201,538,258,280,92.14
MANANG,Chame Gaunpalika,524 4 38 4 003,40203,1129,597,532,112.22
DOLPA,Chharka Tangsong Gaunpalika,524 6 62 4 006,60108,1451,684,767,89.18
MUSTANG,Dalome Gaunpalika,524 4 45 4 002,40301,1423,682,741,92.04
MANANG,Nashong Gaunpalika,524 4 38 4 004,40204,1938,955,983,97.15
BAJHANG,Kanda Gaunpalika,524 7 67 4 001,70201,2182,1106,1076,102.79
MUSTANG,Lomanthang Gaunpalika,524 4 45 4 001,40304,1899,868,1031,84.19
DOLPA,Jagadulla Gaunpalika,524 6 62 4 002,60103,2273,1101,1172,93.94
MANANG,Neshang Gaunpalika,524 4 38 4 001,40202,2222,1205,1017,118.49
DOLPA,Dolpo Buddha Gaunpalika,524 6 62 4 003,60101,2126,969,1157,83.75
MUSTANG,Bahragaun Muktikshetra Gaunpalika,524 4 45 4 003,40303,2330,1121,1209,92.72
MUSTANG,Thasang Gaunpalika,524 4 45 4 005,40305,2912,1506,1406,107.11
MUSTANG,Gharpajhong Gaunpalika,524 4 45 4 004,40302,3029,1594,1435,111.08
DOLPA,Shey Phoksundo Gaunpalika,524 6 62 4 001,60102,3099,1512,1587,95.27
DOLPA,Kaike Gaunpalika,524 6 62 4 005,60107,3576,1657,1919,86.35
HUMLA,Namkha Gaunpalika,524 6 66 4 001,60304,3900,1886,2014,93.64
DOLPA,Mudkechula Gaunpalika,524 6 62 4 004,60104,5129,2596,2533,102.49
HUMLA,Chankheli Gaunpalika,524 6 66 4 005,60301,5517,2788,2729,102.16
MUGU,Mugumakarmarog Gaunpalika,524 6 65 4 003,60201,5396,2598,2798,92.85
HUMLA,Tanjakot Gaunpalika,524 6 66 4 006,60307,5964,2948,3016,97.75
SOLUKHUMBU,Likhu Pike Gaunpalika,524 1 11 4 003,10308,5534,2658,2876,92.42
RASUWA,Parbatikunda Gaunpalika,524 3 29 4 001,30302,5490,2697,2793,96.56
HUMLA,Kharpunath Gaunpalika,524 6 66 4 003,60302,6011,2967,3044,97.47
DARCHULA,Apihimal Gaunpalika,524 7 75 4 003,70305,6779,3379,3400,99.38
HUMLA,Adanchuli Gaunpalika,524 6 66 4 007,60306,7116,3543,3573,99.16
SANKHUWASABHA,Bhotkhola Gaunpalika,524 1 09 4 002,10201,6576,3204,3372,95.02
SANKHUWASABHA,Chichila Gaunpalika,524 1 09 4 004,10204,7065,3410,3655,93.3
RASUWA,Gosaikunda Gaunpalika,524 3 29 4 002,30301,7143,3697,3446,107.28
KALIKOT,Mahawai Gaunpalika,524 6 64 4 006,60508,8323,4195,4128,101.62
GORKHA,Chumanubri Gaunpalika,524 4 36 4 001,40101,6923,3258,3665,88.89
BAJHANG,Surma Gaunpalika,524 7 67 4 002,70203,9022,4547,4475,101.61
BAJURA,Gaumul Gaunpalika,524 7 68 4 002,70102,8515,4166,4349,95.79
DOLPA,Thulibheri Municipality,524 6 62 3 002,60106,8370,4196,4174,100.53
TERHATHUM,Menchhayayem Gaunpalika,524 1 08 4 001,10803,8078,3683,4395,83.8
RASUWA,Uttargaya Gaunpalika,524 3 29 4 003,30303,8255,3845,4410,87.19
BAJURA,Himali Gaunpalika,524 7 68 4 001,70101,9214,4625,4589,100.78
BAJURA,Pandab Gufa Gaunpalika,524 7 68 4 004,70105,9432,4651,4781,97.28
HUMLA,Sarkegad Gaunpalika,524 6 66 4 004,60305,9868,4977,4891,101.76
TAPLEJUNG,Mikwakhola Gaunpalika,524 1 01 4 002,10102,9160,4313,4847,88.98
LALITPUR,Mahankal Gaunpalika,524 3 25 4 003,30805,9453,4583,4870,94.11
JUMLA,Guthichaur Gaunpalika,524 6 63 4 007,60405,9870,4867,5003,97.28
SOLUKHUMBU,Sotang Gaunpalika,524 1 11 4 007,10303,9530,4700,4830,97.31
SOLUKHUMBU,Khumbu Pasanglhamu Gaunpalika,524 1 11 4 001,10301,8989,4493,4496,99.93
RASUWA,Kalika Gaunpalika,524 3 29 4 004,30304,9421,4486,4935,90.9
JUMLA,Hima Gaunpalika,524 6 63 4 004,60408,10553,5223,5330,97.99
DOLPA,Tripurasundari Municipality,524 6 62 3 001,30210,10104,4966,5138,96.65
LALITPUR,Konjyosom Gaunpalika,524 3 25 4 002,30804,9709,4596,5113,89.89
DHADING,Rubi Valley Gaunpalika,524 3 30 4 001,30401,9562,4462,5100,87.49
DARCHULA,Byas Gaunpalika,524 7 75 4 001,40702,10347,4865,5482,88.74
SANKHUWASABHA,Sabhapokhari Gaunpalika,524 1 09 4 005,10205,10492,5029,5463,92.06
PARBAT,Mahashila Gaunpalika,524 4 42 4 004,41005,9858,4392,5466,80.35
DARCHULA,Duhun Gaunpalika,524 7 75 4 002,70302,10818,5102,5716,89.26
JUMLA,Sinja Gaunpalika,524 6 63 4 002,60403,11993,6046,5947,101.66
LAMJUNG,Kwhola Sothar Gaunpalika,524 4 37 4 001,40603,10032,4512,5520,81.74
BAJHANG,Talkot Gaunpalika,524 7 67 4 003,70204,11557,5541,6016,92.1
ROLPA,Thawang Gaunpalika,524 5 54 4 003,50202,10881,5035,5846,86.13
TAPLEJUNG,Maiwakhola Gaunpalika,524 1 01 4 005,10104,11037,5194,5843,88.89
KALIKOT,Pachal Jharana Gaunpalika,524 6 64 4 003,60502,12343,6260,6083,102.91
HUMLA,Simkot Gaunpalika,524 6 66 4 002,60303,11557,5968,5589,106.78
MUGU,Soru Gaunpalika,524 6 65 4 002,60203,12238,6115,6123,99.87
SOLUKHUMBU,Mahakulung Gaunpalika,524 1 11 4 002,10302,11452,5619,5833,96.33
BAGLUNG,Tamankhola Gaunpalika,524 4 43 4 002,41104,10659,4677,5982,78.18
SANKHUWASABHA,Silichong Gaunpalika,524 1 09 4 003,10203,11806,5746,6060,94.82
RASUWA,Naukunda Gaunpalika,524 3 29 4 005,30305,11824,5773,6051,95.41
KHOTANG,Sakela Gaunpalika,524 1 12 4 005,10506,11594,5463,6131,89.1
LAMJUNG,Dudhapokhari Gaunpalika,524 4 37 4 004,40608,10975,5020,5955,84.3
KALIKOT,Sanni Tribeni Gaunpalika,524 6 64 4 002,60504,12846,6378,6468,98.61
UDAYAPUR,Sunkoshi Gaunpalika,524 1 14 4 002,10407,11992,5662,6330,89.45
TAPLEJUNG,Phaktanlung Gaunpalika,524 1 01 4 001,10101,12017,5880,6137,95.81
TAPLEJUNG,Sidingba Gaunpalika,524 1 01 4 008,10109,12099,5777,6322,91.38
BAJURA,Swami Kartik Gaunpalika,524 7 68 4 005,70104,12784,6226,6558,94.94
JUMLA,Kanaka Sundari Gaun Palika,524 6 63 4 001,60402,13216,6590,6626,99.46
JUMLA,Tila Gaunpalika,524 6 63 4 005,60407,13607,6866,6741,101.85
BAGLUNG,Tarakhola Gaunpalika,524 4 43 4 004,41103,12009,5365,6644,80.75
LALITPUR,Bagmati Gaunpalika,524 3 25 4 001,20503,13049,6454,6595,97.86
TAPLEJUNG,Meringden Gaunpalika,524 1 01 4 004,10103,12548,5809,6739,86.2
SALYAN,Dhorchaur Gaunpalika,524 6 53 4 003,60904,13593,6504,7089,91.75
BAJHANG,Durgathali Gaunpalika,524 7 67 4 006,70208,12972,5915,7057,83.82
KALIKOT,Kalika Gaunpalika,524 6 64 4 005,30304,14080,7026,7054,99.6
DHADING,Khaniyabas Gaunpalika,524 3 30 4 003,30402,12749,5847,6902,84.71
BHOJPUR,Salpa Silichho Gaunpalika,524 1 10 4 001,10602,13111,6265,6846,91.51
SOLUKHUMBU,Dhudhakoshi Gaunpalika,524 1 11 4 004,10304,13414,6529,6885,94.83
SANKHUWASABHA,Makalu Gaunpalika,524 1 09 4 001,10202,13572,6790,6782,100.12
KAVREPALANCHOK,Khanikhola Gaunpalika,524 3 24 4 006,30913,14398,7064,7334,96.32
SINDHULI,Ghyanglekha Gaunpalika,524 3 20 4 003,31107,13761,6471,7290,88.77
JUMLA,Patarasi Gaunpalika,524 6 63 4 003,60401,14571,7288,7283,100.07
DADELDHURA,Bhageshwor Gaunpalika,524 7 73 4 001,70504,14129,6728,7401,90.91
KALIKOT,Palata Gaunpalika,524 6 64 4 004,60501,15303,7763,7540,102.96
PANCHTHAR,Tumbewa Gaunpalika,524 1 02 4 006,10907,13419,6265,7154,87.57
KHOTANG,Lamidanda Gaunpalika,524 1 12 4 003,10503,13369,6178,7191,85.91
JUMLA,Tatopani Gaunpalika,524 6 63 4 006,60406,14638,7347,7291,100.77
TAPLEJUNG,Yangwarak Gaunpalika,524 1 01 4 007,10107,13591,6295,7296,86.28
DARCHULA,Marma Gaunpalika,524 7 75 4 007,70306,14956,7268,7688,94.54
KHOTANG,Baraha Pokhari Gaunpalika,524 1 12 4 007,10510,14349,6831,7518,90.86
TAPLEJUNG,Aatharai Tribeni Gaunpalika,524 1 01 4 006,10105,13784,6414,7370,87.03
JAJARKOT,Shivalaya Gaunpalika,524 6 60 4 004,60705,15269,7543,7726,97.63
BAJHANG,Masta Gaunpalika,524 7 67 4 008,70205,14951,7111,7840,90.7
MAKWANPUR,Indrasarowar Gaunpalika,524 3 31 4 005,31201,13809,6509,7300,89.16
SINDHUPALCHOK,Tripurasundari Gaunpalika,524 3 23 4 008,30210,13197,6215,6982,89.01
GORKHA,Dharche Gaunpalika,524 4 36 4 004,40104,13229,5977,7252,82.42
DHADING,Netrawati Gaunpalika,524 3 30 4 005,30405,12870,5603,7267,77.1
OKHALDHUNGA,Likhu Gaunpalika,524 1 13 4 002,10405,14049,6522,7527,86.65
PARBAT,Bihadi Gaunpalika,524 4 42 4 003,41006,13403,5849,7554,77.43
KALIKOT,Tilagupha Municipality,524 6 64 3 003,60507,15766,7854,7912,99.27
NUWAKOT,Meghang Gaunpalika,524 3 28 4 001,30506,13479,6059,7420,81.66
DARCHULA,Naugad  Gaunpalika,524 7 75 4 005,70304,15874,7624,8250,92.41
KALIKOT,Raskot Municipality,524 6 64 3 001,60503,16272,8076,8196,98.54
MYAGDI,Annapurna Gaunpalika,524 4 44 4 003,40401,13315,6098,7217,84.49
DARCHULA,Lekam Gaunpalika,524 7 75 4 006,70309,14838,6754,8084,83.55
OKHALDHUNGA,Khiji Demba Gaunpalika,524 1 13 4 001,10404,15106,7273,7833,92.85
MYAGDI,Dhawalagiri Gaunpalika,524 4 44 4 001,40403,14104,6334,7770,81.52
SANKHUWASABHA,Madi Municipality,524 1 09 3 005,10209,14470,6623,7847,84.4
KHOTANG,Jante Dhunga Gaunpalika,524 1 12 4 008,10509,15444,7420,8024,92.47
DOTI,Badi Kedar Gaunpalika,524 7 70 4 006,70608,16720,8196,8524,96.15
NUWAKOT,Kispang Gaunpalika,524 3 28 4 002,30505,14861,6942,7919,87.66
MUGU,Khatyad Gaunpalika,524 6 65 4 001,60204,17116,8629,8487,101.67
KHOTANG,Kepilasgadhi Gaunpalika,524 1 12 4 002,10501,15288,7323,7965,91.94
DAILEKH,Dungeshwor Gaunpalika,524 6 61 4 006,60610,15883,7553,8330,90.67
DARCHULA,Malikarjun Gaunpalika,524 7 75 4 004,70308,15581,7239,8342,86.78
PYUTHAN,Mandavi Gaunpalika,524 5 55 4 004,50306,15058,6577,8481,77.55
TAPLEJUNG,Sirijanga Gaunpalika,524 1 01 4 003,10108,15806,7482,8324,89.88
NUWAKOT,Panchakanya Gaunpalika,524 3 28 4 007,30510,15945,7711,8234,93.65
BHOJPUR,Pauwa Dunma Gaunpalika,524 1 10 4 005,10606,15394,7118,8276,86.01
OKHALDHUNGA,Chishankhu Gadhi Gaunpalika,524 1 13 4 006,10401,15196,6968,8228,84.69
BAGLUNG,Bareng Gaunpalika,524 4 43 4 006,41109,14492,6164,8328,74.02
BAJHANG,Chhabis Pathibhara Gaunpalika,524 7 67 4 007,70207,16296,7679,8617,89.11
BAJURA,Badimalika Municipality,524 7 68 3 002,70106,16818,8656,8162,106.05
ROLPA,Sunchhahari Gaunpalika,524 5 54 4 007,50209,16034,7434,8600,86.44
DADELDHURA,Ganyapdhura Gaunpalika,524 7 73 4 005,70507,15093,6545,8548,76.57
SINDHUPALCHOK,Lisankhu Pakhar Gaunpalika,524 3 23 4 009,30211,15133,7101,8032,88.41
NAWALPARASI,Bungdikali Gaunpalika,524 4 47 4 001,40803,15734,6990,8744,79.94
BAJHANG,Bitthadchir Gaunpalika,524 7 67 4 004,70210,17154,8118,9036,89.84
BAITADI,Shivanath Gaunpalika,524 7 74 4 005,70407,17115,8065,9050,89.12
BAJHANG,Khaptad Chhanna Gaunpalika,524 7 67 4 010,70212,15893,7150,8743,81.78
SINDHULI,Phikkal Gaunpalika,524 3 20 4 007,31102,16968,8143,8825,92.27
PARBAT,Paiyu Gaunpalika,524 4 42 4 005,41007,15381,6795,8586,79.14
SURKHET,Chingad Gaunpalika,524 6 59 4 003,61002,17275,8287,8988,92.2
ILAM,Sandakpur Gaunpalika,524 1 03 4 002,11002,16065,7790,8275,94.14
KASKI,Rupa Gaunpalika,524 4 39 4 004,40505,14519,6289,8230,76.42
TANAHU,Devghat Gaunpalika,524 4 40 4 006,40708,16131,7484,8647,86.55
RUKUM,Sisne Gaunpalika,524 5 77 4 001,50102,16497,7890,8607,91.67
NUWAKOT,Suryagadhi Gaunpalika,524 3 28 4 004,30503,16800,8194,8606,95.21
KHOTANG,Aiselukharka Gaunpalika,524 1 12 4 001,10502,16097,7456,8641,86.29
NUWAKOT,Tarakeshwor Gaunpalika,524 3 28 4 003,30507,15719,7034,8685,80.99
PANCHTHAR,Kummayak Gaunpalika,524 1 02 4 004,10906,16118,7401,8717,84.9
DOLAKHA,Jiri Municipality,524 3 22 3 002,30105,15515,7141,8374,85.28
SOLUKHUMBU,Necha Salyan Gaunpalika,524 1 11 4 005,10306,16129,7514,8615,87.22
KAVREPALANCHOK,Mahabharat Gaunpalika,524 3 24 4 007,30912,18283,8941,9342,95.71
SALYAN,Tribeni Gaunpalika,524 6 53 4 006,50206,16624,7726,8898,86.83
OKHALDHUNGA,Molung Gaunpalika,524 1 13 4 003,10403,16241,7529,8712,86.42
SINDHUPALCHOK,Bhotekoshi Gaunpalika,524 3 23 4 004,30201,16631,8431,8200,102.82
DADELDHURA,Ajayameru Gaunpalika,524 7 73 4 002,70503,17066,7894,9172,86.07
NUWAKOT,Tadi Gaunpalika,524 3 28 4 005,30502,17932,8977,8955,100.25
DOTI,Bogatan Gaunpalika,524 7 70 4 007,70607,17902,8480,9422,90
TERHATHUM,Chhathar Gaunpalika,524 1 08 4 004,10806,16715,7679,9036,84.98
NUWAKOT,Likhu Gaunpalika,524 3 28 4 006,10405,16852,7807,9045,86.31
PARSA,Dhobini Gaunpalika,524 2 34 4 006,20811,19911,10192,9719,104.87
KAVREPALANCHOK,Bethanchowk Gaunpalika,524 3 24 4 003,30910,16777,7679,9098,84.4
DAILEKH,Thantikandh Gaunpalika,524 6 61 4 001,60604,18896,9389,9507,98.76
DADELDHURA,Aalital Gaunpalika,524 7 73 4 004,70506,18531,8946,9585,93.33
BAJURA,Budhinanda Municipality,524 7 68 3 001,70103,18776,9351,9425,99.21
TERHATHUM,Laligurans Municipality,524 1 08 3 001,10805,16934,7728,9206,83.95
BAJHANG,Thalara Gaunpalika,524 7 67 4 009,70211,17952,8261,9691,85.24
BAJURA,Chhededaha Gaunpalika,524 7 68 4 003,70107,18575,8797,9778,89.97
PARSA,Pakaha Mainpur Gaunpalika,524 2 34 4 009,20813,20717,10799,9918,108.88
KAILALI,Chure Gaunpalika,524 7 71 4 001,70802,18924,9329,9595,97.23
DOLAKHA,Gaurishankar Gaunpalika,524 3 22 4 002,30101,17062,8169,8893,91.86
MYAGDI,Raghuganga Gaunpalika,524 4 44 4 002,40402,15753,6881,8872,77.56
SIRAHA,Nawarajpur Gaunpalika,524 2 16 4 007,20214,19019,9315,9704,95.99
MYAGDI,Mangala Gaunpalika,524 4 44 4 005,40405,16286,7114,9172,77.56
SANKHUWASABHA,Panchakhapan Municipality,524 1 09 3 002,10207,17521,8143,9378,86.83
BAJURA,Tribeni Municipality,524 7 68 3 004,50206,18363,8631,9732,88.69
SIRAHA,Sakhuwa Nankarkatti Gaunpalika,524 2 16 4 008,20212,18558,8862,9696,91.4
SIRAHA,Bishnupur Gaunpalika,524 2 16 4 002,20112,18522,8862,9660,91.74
DAILEKH,Bhagawatimai Gaunpalika,524 6 61 4 007,60609,18778,8996,9782,91.96
SALYAN,Kapurkot Gaunpalika,524 6 53 4 007,60910,18204,8718,9486,91.9
SYANGJA,Arjun Choupari Gaunpalika,524 4 41 4 003,40904,16179,6952,9227,75.34
ILAM,Mangsebung Gaunpalika,524 1 03 4 005,11006,18503,9049,9454,95.72
RAMECHHAP,Umakunda Gaunpalika,524 3 21 4 004,31001,17601,8243,9358,88.09
ACHHAM,Bannigadhi Jayagadh Gaunpalika,524 7 69 4 003,70707,17359,7496,9863,76
PARSA,Kalikamai Gaunpalika,524 2 34 4 008,20810,21141,10939,10202,107.22
RUKUM,Putha Uttanganga Gaunpalika,524 5 77 4 002,50101,17932,8512,9420,90.36
SINDHUPALCHOK,Helambu Gaunpalika,524 3 23 4 001,30204,17671,8564,9107,94.04
BHOJPUR,Arun Gaunpalika,524 1 10 4 003,10605,17687,8127,9560,85.01
TERHATHUM,Phedap Gaunpalika,524 1 08 4 002,10802,17700,8121,9579,84.78
BHOJPUR,Aamchowk Gaunpalika,524 1 10 4 006,10609,18720,9008,9712,92.75
PANCHTHAR,Yangbarak Gaunpalika,524 1 02 4 002,10107,18281,8701,9580,90.82
BAITADI,Surnaya Gaunpalika,524 7 74 4 003,70404,18549,8471,10078,84.05
ROLPA,Madi Gaunpalika,524 5 54 4 004,10209,17986,8191,9795,83.62
MUGU,Chhayanath Rara Municipality,524 6 65 3 001,60202,20082,10247,9835,104.19
KALIKOT,Khandachakra Municipality,524 6 64 3 002,60506,20288,10334,9954,103.82
SINDHUPALCHOK,Jugal Gaunpalika,524 3 23 4 003,30202,19231,9581,9650,99.28
BAITADI,Pancheshwor Gaunpalika,524 7 74 4 004,70406,18766,8484,10282,82.51
SINDHULI,Golanjor Gaunpalika,524 3 20 4 005,31104,19329,9400,9929,94.67
SYANGJA,Aandhikhola Gaunpalika,524 4 41 4 001,40903,16589,7072,9517,74.31
JUMLA,Chandannath Municipality,524 6 63 3 001,60404,19047,9369,9678,96.81
SALYAN,Darma Gaunpalika,524 6 53 4 002,60901,19966,9746,10220,95.36
DHANKUTA,Khalsa Chhintang Sahidbhumi Gaunpalika,524 1 07 4 001,10705,18760,8931,9829,90.86
SINDHUPALCHOK,Sunkoshi Gaunpalika,524 3 23 4 007,10407,17246,7883,9363,84.19
RUKUM,Banphikot Gaunpalika,524 6 52 4 002,60803,18696,8713,9983,87.28
SIRAHA,Naraha Gaunpalika,524 2 16 4 001,20207,19369,9303,10066,92.42
SARLAHI,Parsa Gaunpalika,524 2 19 4 009,20508,21650,11227,10423,107.71
SYANGJA,Harinas Gaunpalika,524 4 41 4 005,40907,17343,7464,9879,75.55
BHOJPUR,Tyamke Maiyum Gaunpalika,524 1 10 4 002,10603,18211,8483,9728,87.2
SANKHUWASABHA,Dharmadevi Municipality,524 1 09 3 004,10210,18235,8392,9843,85.26
PYUTHAN,Sarumarani Gaunpalika,524 5 55 4 006,50309,18627,8309,10318,80.53
JAJARKOT,Kuse Gaunpalika,524 6 60 4 002,60702,20621,10407,10214,101.89
RAMECHHAP,Sunapati Gaunpalika,524 3 21 4 001,31008,18128,8348,9780,85.36
OKHALDHUNGA,Champadevi Gaunpalika,524 1 13 4 004,10406,18613,8521,10092,84.43
DAILEKH,Mahabu Gaunpalika,524 6 61 4 003,60602,19277,8933,10344,86.36
NAWALPARASI,Bulingtar Gaunpalika,524 4 47 4 002,40802,19122,8663,10459,82.83
RUKUM,Bhoome Gaunpalika,524 5 77 4 003,50103,18589,8443,10146,83.22
OKHALDHUNGA,Sunkoshi Gaunpalika,524 1 13 4 005,10407,18550,8541,10009,85.33
DOLAKHA,Bigu Gaunpalika,524 3 22 4 001,30102,18449,8846,9603,92.12
BARA,Parawanipur Gaunpalika,524 2 33 4 001,20704,22787,11914,10873,109.57
DHANUSA,Bateshwor Gaunpalika,524 2 17 4 001,20304,21530,11149,10381,107.4
ILAM,Rong Gaunpalika,524 1 03 4 006,11010,19135,9389,9746,96.34
BHOJPUR,Ramprasad Rai Gaunpalika,524 1 10 4 004,10607,18888,8777,10111,86.81
PALPA,Tinau Gaunpalika,524 5 46 4 002,50608,19085,8814,10271,85.81
RUKUM,Tribeni Gaunpalika,524 6 52 4 003,50206,19404,8839,10565,83.66
DHANKUTA,Chhathar Jorpati Gaunpalika,524 1 07 4 002,10703,18322,8346,9976,83.66
DHANUSA,Dhanauji Gaunpalika,524 2 17 4 004,20316,21395,10894,10501,103.74
ROLPA,Sukidaha Gaunpalika,524 5 54 4 005,50201,20009,9217,10792,85.41
LAMJUNG,Dordi Gaunpalika,524 4 37 4 003,40601,18252,8337,9915,84.08
PYUTHAN,Mallarani Gaunpalika,524 5 55 4 005,50307,17686,7544,10142,74.38
BARA,Devtal Gaunpalika,524 2 33 4 007,20715,23223,12108,11115,108.93
SIRAHA,Bhagawanpur Gaunpalika,524 2 16 4 009,20213,20957,10291,10666,96.48
SINDHUPALCHOK,Balephi Gaunpalika,524 3 23 4 006,30208,18909,9002,9907,90.87
KALIKOT,Naraharinath Gaunpalika,524 6 64 4 001,60505,21366,10603,10763,98.51
DOLAKHA,Tamakoshi Gaunpalika,524 3 22 4 007,30106,18849,8776,10073,87.12
KASKI,Madi Gaunpalika,524 4 39 4 003,10209,18153,8241,9912,83.14
DOTI,Sayal Gaunpalika,524 7 70 4 002,70602,19551,8859,10692,82.86
DAILEKH,Naumule Gaunpalika,524 6 61 4 004,60601,20802,10045,10757,93.38
DOTI,Jorayal Gaunpalika,524 7 70 4 004,70609,20824,10156,10668,95.2
SOLUKHUMBU,Dhudha Koushika Gaunpalika,524 1 11 4 006,10305,19672,9431,10241,92.09
LAMJUNG,Marshyangdi Gaunpalika,524 4 37 4 002,40602,18759,8619,10140,85
KAVREPALANCHOK,Bhumlu Gaunpalika,524 3 24 4 001,30902,18916,8816,10100,87.29
RAUTAHAT,Durga Bhagawati Gaunpalika,524 2 32 4 002,20615,22699,11892,10807,110.04
BARA,Bishrampur Gaunpalika,524 2 33 4 004,20706,23785,12547,11238,111.65
SYANGJA,Biruwa Gaunpalika,524 4 41 4 004,40906,18413,8045,10368,77.59
GULMI,Kali Gandaki Gaunpalika,524 5 51 4 010,40911,18876,8275,10601,78.06
MYAGDI,Malika Gaunpalika,524 4 44 4 004,40404,19121,8605,10516,81.83
JAJARKOT,Junichande Gaunpalika,524 6 60 4 001,60703,21733,10740,10993,97.7
DAILEKH,Bhairabi Gaunpalika,524 6 61 4 002,60603,21233,10440,10793,96.73
PARSA,Thori Gaunpalika,524 2 34 4 001,20801,20397,9832,10565,93.06
BAJHANG,Kedarsyun Gaunpalika,524 7 67 4 005,70209,21307,10046,11261,89.21
BAITADI,Sigas Gaunpalika,524 7 74 4 006,70410,21510,10371,11139,93.11
KHOTANG,Diprung Gaunpalika,524 1 12 4 004,10507,20175,9357,10818,86.49
ACHHAM,Dhakari Gaunpalika,524 7 69 4 005,70709,21562,10381,11181,92.85
SAPTARI,Balan-Bihul Gaunpalika,524 2 15 4 004,20108,21819,10796,11023,97.94
SARLAHI,Basbariya Gaunpalika,524 2 19 4 001,20513,23568,12193,11375,107.19
DHANKUTA,Chaubise Gaunpalika,524 1 07 4 004,10707,19283,8723,10560,82.6
KAILALI,Mohanyal Gaunpalika,524 7 71 4 003,70801,22053,10914,11139,97.98
PALPA,Purbakhola Gaunpalika,524 5 46 4 006,50602,19589,8563,11026,77.66
KANCHANPUR,Laljhadi Gaunpalika,524 7 72 4 002,70906,22569,11086,11483,96.54
TERHATHUM,Myanglung Municipality,524 1 08 3 002,10804,19659,9109,10550,86.34
SAPTARI,Tirahut Gaunpalika,524 2 15 4 003,20115,22010,10913,11097,98.34
LAMJUNG,Rainas Municipality,524 4 37 3 004,40607,18527,8099,10428,77.67
RAMECHHAP,Gokulganga Gaunpalika,524 3 21 4 003,31002,20058,9284,10774,86.17
TANAHU,Ghiring Gaunpalika,524 4 40 4 002,40706,19318,8225,11093,74.15
DHANUSA,Aurahi Gaunpalika,524 2 17 4 003,20404,22578,11331,11247,100.75
SINDHUPALCHOK,Panchpokhari Thangpal Gaunpalika,524 3 23 4 002,30203,20860,10605,10255,103.41
ILAM,Mai Jogmai Gaunpalika,524 1 03 4 003,11001,21044,10377,10667,97.28
GULMI,Ruru Gaunpalika,524 5 51 4 008,50412,18581,7892,10689,73.83
PARSA,Bindabasini Gaunpalika,524 2 34 4 010,20814,24468,12636,11832,106.8
NUWAKOT,Dupcheshwor Gaunpalika,524 3 28 4 008,30501,22106,11145,10961,101.68
PALPA,Ribdikot Gaunpalika,524 5 46 4 003,50606,18770,7980,10790,73.96
RAUTAHAT,Yamunamai Gaunpalika,524 2 32 4 001,20614,23884,12211,11673,104.61
DAILEKH,Gurans Gaunpalika,524 6 61 4 005,60611,22033,10675,11358,93.99
KANCHANPUR,Beldandi Gaunpalika,524 7 72 3 006,70908,21949,10240,11709,87.45
DADELDHURA,Nawadurga Gaunpalika,524 7 73 4 003,70501,19957,8607,11350,75.83
BHOJPUR,Hatuwagadhi Gaunpalika,524 1 10 4 007,10608,20404,9482,10922,86.82
PARSA,Jirabhawani Gaunpalika,524 2 34 4 002,20802,22765,11367,11398,99.73
ROLPA,Duikholi Gaunpalika,524 5 54 4 002,50203,20778,9279,11499,80.69
BAJHANG,Jayaprithbi Municipality,524 7 67 3 002,70206,22191,10655,11536,92.36
DARCHULA,Mahakali Municipality,524 7 75 3 001,70303,21231,10162,11069,91.81
DARCHULA,Shailyashikhar Municipality,524 7 75 3 002,70307,22060,10471,11589,90.35
SAPTARI,Saptakoshi Municipality,524 2 15 3 004,20101,21131,10018,11113,90.15
NUWAKOT,Shivapuri Gaunpalika,524 3 28 4 010,30511,20769,9752,11017,88.52
SOLUKHUMBU,Solu Dhudhakunda Municipality,524 1 11 3 001,10307,20399,9627,10772,89.37
RUKUM,Sanibheri Gaunpalika,524 6 52 4 001,60802,22194,10533,11661,90.33
BARA,Prasauni Gaunpalika,524 2 33 4 002,20705,25049,12872,12177,105.71
ILAM,Chulachuli Gaunpalika,524 1 03 4 004,11007,20820,9652,11168,86.43
TANAHU,Bandipur Gaunpalika,524 4 40 4 004,40709,20013,9048,10965,82.52
PARSA,Paterwa Sugauli Gaunpalika,524 2 34 4 003,20804,23901,12080,11821,102.19
DOLAKHA,Baitedhar Gaunpalika,524 3 22 4 004,20304,19876,9095,10781,84.36
DOLAKHA,Shailung Gaunpalika,524 3 22 4 005,30108,19698,8786,10912,80.52
SARLAHI,Bishnu Gaunpalika,524 2 19 4 008,20518,24748,12861,11887,108.19
DANG,Dangisharan Gaunpalika,524 5 56 4 002,51006,21484,9983,11501,86.8
SAPTARI,Bishnupur Gaunpalika,524 2 15 4 007,20112,23038,11438,11600,98.6
BAJURA,Budhiganga Municipality,524 7 68 3 003,11213,21677,9975,11702,85.24
SIRAHA,Arnama Gaunpalika,524 2 16 4 003,20209,22912,10940,11972,91.38
DADELDHURA,Amargadhi Municipality,524 7 73 3 002,70502,21245,10003,11242,88.98
KAVREPALANCHOK,Chauri Deurali Gaunpalika,524 3 24 4 002,30901,20829,9468,11361,83.34
DOLAKHA,Melung Gaunpalika,524 3 22 4 006,30107,20210,9015,11195,80.53
SINDHULI,Sunkoshi Gaunpalika,524 3 20 4 004,10407,21473,9988,11485,86.97
BAITADI,Dilasaini Gaunpalika,524 7 74 4 001,70401,22924,10990,11934,92.09
SALYAN,Kalimati Gaunpalika,524 6 53 4 004,60908,23005,11300,11705,96.54
BAITADI,Melauli Municipality,524 7 74 3 003,70408,22545,10434,12111,86.15
BARA,Pheta Gaunpalika,524 2 33 4 005,20707,25653,13166,12487,105.44
SARLAHI,Dhanakaul Gaunpalika,524 2 19 4 003,20514,24788,12672,12116,104.59
OKHALDHUNGA,Manebhanjyang Gaunpalika,524 1 13 4 007,10408,21074,9598,11476,83.64
SALYAN,Chhatreshwori Gaunpalika,524 6 53 4 005,60906,21452,9762,11690,83.51
PANCHTHAR,Falelung Gaunpalika,524 1 02 4 003,10903,21884,10320,11564,89.24
ILAM,Fakfokathum Gaunpalika,524 1 03 4 001,11005,21619,10112,11507,87.88
DOTI,K.I. Singh Gaunpalika,524 7 70 4 005,70606,20903,8993,11910,75.51
TERHATHUM,Aatharai Gaunpalika,524 1 08 4 003,10801,21747,10132,11615,87.23
MAKWANPUR,Kailash Gaunpalika,524 3 31 4 003,31203,23922,11943,11979,99.7
PALPA,Nisdi Gaunpalika,524 5 46 4 008,50610,22611,10215,12396,82.41
DHANUSA,Mukhiyapatti Musaharmiya Gaunpalika,524 2 17 4 005,20318,25482,13266,12216,108.6
PALPA,Rambha Gaunpalika,524 5 46 4 007,50603,20190,8452,11738,72.01
DHANKUTA,Sangurigadhi Gaunpalika,524 1 07 4 003,10706,21536,10089,11447,88.14
RAUTAHAT,Maulapur Municipality,524 2 32 3 006,20610,26424,13651,12773,106.87
GULMI,Malika Gaunpalika,524 5 51 4 002,40404,21729,9602,12127,79.18
KHOTANG,Khotehang Gaunpalika,524 1 12 4 006,10508,22474,10449,12025,86.89
ROLPA,Tribeni Gaunpalika,524 5 54 4 006,50206,22957,10729,12228,87.74
SARLAHI,Kaudena Gaunpalika,524 2 19 4 006,20519,26085,13387,12698,105.43
GULMI,Isma Gaunpalika,524 5 51 4 004,50405,20964,8908,12056,73.89
UDAYAPUR,Rautamai Gaunpalika,524 1 14 4 004,11404,23481,11179,12302,90.87
MAKWANPUR,Bhimphedi Gaunpalika,524 3 31 4 004,31207,23344,11183,12161,91.96
DHANKUTA,Pakhribas Municipality,524 1 07 3 002,10702,22078,10054,12024,83.62
KAVREPALANCHOK,Temal Gaunpalika,524 3 24 4 005,30907,22712,10583,12129,87.25
SIRAHA,Bariyarpatti Gaunpalika,524 2 16 4 005,20215,25256,12505,12751,98.07
PARSA,Chhipaharmai Gaunpalika,524 2 34 4 007,20812,26671,13634,13037,104.58
PANCHTHAR,Hilihan Gaunpalika,524 1 02 4 001,10902,22913,10646,12267,86.79
DHADING,Ganga Jamuna Gaunpalika,524 3 30 4 002,30403,21784,9527,12257,77.73
GULMI,Madane Gaunpalika,524 5 51 4 001,50407,21899,9605,12294,78.13
ACHHAM,Kamal bazar Municipality,524 7 69 3 003,70708,23738,11048,12690,87.06
BARA,Karaiyamai Gaunpalika,524 2 33 4 003,20709,26487,13475,13012,103.56
DANG,Rajpur Gaunpalika,524 5 56 4 004,20613,25037,12251,12786,95.82
PARBAT,Jaljala Gaunpalika,524 4 42 4 001,41002,21454,9708,11746,82.65
SYANGJA,Kaligandaki Gaunpalika,524 4 41 4 006,40911,21718,9372,12346,75.91
CHITAWAN,Ichchha Kamana Gaunpalika,524 3 35 4 001,31303,25002,12460,12542,99.35
BARA,Aadarsha Kotwal Gaunpalika,524 2 33 4 009,20711,27552,14176,13376,105.98
PYUTHAN,Aairawati Gaunpalika,524 5 55 4 007,50308,22392,9665,12727,75.94
KASKI,Machhapuchchhre Gaunpalika,524 4 39 4 002,40502,21868,9970,11898,83.8
ACHHAM,Ramaroshan Gaunpalika,524 7 69 4 004,70702,25166,12109,13057,92.74
RAMECHHAP,Likhu Gaunpalika,524 3 21 4 006,10405,23109,10615,12494,84.96
RAMECHHAP,Doramba Gaunpalika,524 3 21 4 002,31007,22738,10302,12436,82.84
DOLAKHA,Kalinchowk Gaunpalika,524 3 22 4 003,30103,22954,10946,12008,91.16
PARBAT,Modi Gaunpalika,524 4 42 4 002,41001,21284,9282,12002,77.34
DHANUSA,Janak Nandini Gaunpalika,524 2 17 4 006,20312,25338,12309,13029,94.47
ACHHAM,Mellekh Gaunpalika,524 7 69 4 002,70703,24670,11537,13133,87.85
ACHHAM,Turmakhand Gaunpalika,524 7 69 4 006,70710,24764,11839,12925,91.6
ROLPA,Lungri Gaunpalika,524 5 54 4 008,50210,23631,10504,13127,80.02
GULMI,Chandrakot Gaunpalika,524 5 51 4 006,50403,21827,9395,12432,75.57
JAJARKOT,Tribeni Nalagad Municipality,524 6 60 3 003,60707,25590,12741,12849,99.16
DOTI,Purbichouki Gaunpalika,524 7 70 4 003,70601,22483,9704,12779,75.94
PALPA,Baganaskali Gaunpalika,524 5 46 4 005,50604,21361,9010,12351,72.95
BARA,Baragadhi Gaunpalika,524 2 33 4 006,20710,27191,13839,13352,103.65
SURKHET,Chaukune Gaunpalika,524 6 59 4 001,61009,25240,12214,13026,93.77
MAKWANPUR,Raksirang Gaunpalika,524 3 31 4 002,31204,26192,13110,13082,100.21
DAILEKH,Chamunda Bindrasaini Municipality,524 6 61 3 002,60606,26149,13060,13089,99.78
SALYAN,Kumakh Malika Gaunpalika,524 6 53 4 001,60902,24972,11928,13044,91.44
DHADING,Siddhalek Gaunpalika,524 3 30 4 007,30408,23729,10965,12764,85.91
KATHMANDU,Dakshinkali Municipality,524 3 27 3 010,30611,24297,11873,12424,95.57
BAGLUNG,Nisikhola Gaunpalika,524 4 43 4 001,41106,23300,10260,13040,78.68
GORKHA,Gandaki Gaunpalika,524 4 36 4 009,40111,23253,10559,12694,83.18
GULMI,Chhatrakot Gaunpalika,524 5 51 4 007,50411,21481,8846,12635,70.01
BAITADI,Dogada Kedar Gaunpalika,524 7 74 4 002,70402,24632,11220,13412,83.66
GORKHA,Bhimsen Gaunpalika,524 4 36 4 007,40106,22033,9496,12537,75.74
MAKWANPUR,Makawanpurgadhi Gaunpalika,524 3 31 4 006,31208,25322,12279,13043,94.14
SARLAHI,Chakraghatta Gaunpalika,524 2 19 4 004,20512,27952,14306,13646,104.84
DANG,Bangalachuli Gaunpalika,524 5 56 4 005,51001,24245,10879,13366,81.39
PANCHTHAR,Falgunanda Gaunpalika,524 1 02 4 005,10905,24060,11108,12952,85.76
GULMI,Dhurkot Gaunpalika,524 5 51 4 003,50408,22454,9607,12847,74.78
GULMI,Gulmi Durbar Gaunpaika,524 5 51 4 005,50410,22037,9124,12913,70.66
TANAHU,Myagde Gaunpalika,524 4 40 4 001,40703,22502,9886,12616,78.36
DHADING,Tripurasundari Gaunpalika,524 3 30 4 004,60105,22960,10050,12910,77.85
SARLAHI,Ramnagar Gaunpalika,524 2 19 4 005,20515,28727,14922,13805,108.09
BARA,Subarna Gaunpalika,524 2 33 4 008,20716,29537,15280,14257,107.18
NAWALPARASI,Hupsekot Gaunpalika,524 4 47 4 003,40804,25065,11272,13793,81.72
KATHMANDU,Shankharapur Municipality,524 3 27 3 007,30601,25338,12346,12992,95.03
NUWAKOT,Kakani Gaunpalika,524 3 28 4 009,30512,26263,12986,13277,97.81
MAHOTTARI,Mahottari Gaunpalika,524 2 18 4 004,20412,27430,13814,13616,101.45
DOTI,Aadarsha Gaunpalika,524 7 70 4 001,70603,23945,10163,13782,73.74
SAPTARI,Rupani Gaunpalika,524 2 15 4 001,20104,26387,12824,13563,94.55
DHADING,Galchhi Gaunpalika,524 3 30 4 010,30411,25655,12342,13313,92.71
LAMJUNG,Madhya Nepal Municipality,524 4 37 3 001,40604,23385,10469,12916,81.05
PYUTHAN,Gaumukhi Gaunpalika,524 5 55 4 002,50301,25421,11395,14026,81.24
DHANUSA,Laxminiya Gaunpalika,524 2 17 4 002,20306,28251,14420,13831,104.26
KASKI,Annapurna Gaunpalika,524 4 39 4 001,40401,23417,10597,12820,82.66
GORKHA,Aarughat Gaunpalika,524 4 36 4 006,40105,23884,10639,13245,80.32
PANCHTHAR,Miklajung Gaunpalika,524 1 02 4 007,10908,24615,11302,13313,84.89
DANG,Shantinagar Gaunpalika,524 5 56 4 003,51004,25203,11595,13608,85.21
DHANKUTA,Mahalaxmi Municipality,524 1 07 3 001,10701,24800,11337,13463,84.21
PALPA,Mathagadhi Gaunpalika,524 5 46 4 004,50609,25017,11116,13901,79.97
GORKHA,Siranchowk Gaunpalika,524 4 36 4 005,40107,23628,10521,13107,80.27
SINDHULI,Hariharpurgaghi Gaunpalika,524 3 20 4 001,31109,27727,13275,14452,91.86
SURKHET,Simta Gaunpalika,524 6 59 4 004,61001,25845,11843,14002,84.58
ACHHAM,Chaurpati Gaunpalika,524 7 69 4 001,70705,25149,11146,14003,79.6
DHADING,Jwalamukhi Gaunpalika,524 3 30 4 006,30407,23966,10573,13393,78.94
GULMI,Satyawoti Gaunpalika,524 5 51 4 009,50402,23807,10162,13645,74.47
SURKHET,Barahatal Gaunpalika,524 6 59 4 002,61007,26802,12986,13816,93.99
SARLAHI,Brahmapuri Gaunpalika,524 2 19 4 007,20509,29832,15281,14551,105.02
MAHOTTARI,Ekadara Gaunpalika,524 2 18 4 003,20411,29315,14831,14484,102.4
SIRAHA,Laxmipur Patari Gaunpalika,524 2 16 4 006,20211,28054,13528,14526,93.13
RAMECHHAP,Khandadevi Gaunpalika,524 3 21 4 005,31006,25761,11762,13999,84.02
DHADING,Gajuri Gaunpalika,524 3 30 4 009,30410,27084,13311,13773,96.65
SINDHULI,Marin Gaunpalika,524 3 20 4 002,31108,27822,13282,14540,91.35
ACHHAM,Panchdebal Binayak Municipality,524 7 69 3 004,70701,27485,12859,14626,87.92
SAPTARI,Chhinnamasta Gaunpalika,524 2 15 4 008,20118,28390,14199,14191,100.06
SAPTARI,Agmisair Krishna Sabaran Gaunpalika,524 2 15 4 002,20103,27129,12846,14283,89.94
SAPTARI,Mahadewa Gaunpalika,524 2 15 4 005,20114,28542,14215,14327,99.22
SINDHUPALCHOK,Bahrabise Municipality,524 3 23 3 003,30209,26535,12904,13631,94.67
RUKUM,Chaurjahari Municipality,524 6 52 3 002,60806,27438,12995,14443,89.97
PARBAT,Phalebas Municipality,524 4 42 3 002,41004,24687,10665,14022,76.06
TAPLEJUNG,Phungling Municipality,524 1 01 3 001,10106,26406,12465,13941,89.41
RAUTAHAT,Rajdevi Municipality,524 2 32 3 016,20616,30569,15998,14571,109.79
TANAHU,Rhishing Gaunpalika,524 4 40 4 003,40707,25870,11140,14730,75.63
DAILEKH,Aathbis Municipality,524 6 61 3 001,60801,29227,14484,14743,98.24
GORKHA,Sulikot Gaunpalika,524 4 36 4 003,40103,25389,11103,14286,77.72
BAGLUNG,Dhorpatan Municipality,524 4 43 3 001,41105,26215,11784,14431,81.66
DAILEKH,Narayan Municipality,524 6 61 3 004,60608,27037,12645,14392,87.86
SAPTARI,Belhi Chapena Gaunpalika,524 2 15 4 006,20111,29459,14487,14972,96.76
RAUTAHAT,Dewahi Gonahi Municipality,524 2 32 3 007,20609,32143,16451,15692,104.84
SANKHUWASABHA,Chainapur Municipality,524 1 09 3 003,10208,27308,12670,14638,86.56
SYANGJA,Bhirkot Municipaity,524 4 41 3 002,40905,25583,10984,14599,75.24
PARSA,Jagarnathpur Gaunpalika,524 2 34 4 005,20803,32663,16815,15848,106.1
PALPA,Rainadevi Chhahara Gaunpalika,524 5 46 4 001,50607,26469,11659,14810,78.72
RAUTAHAT,Boudhimai Municipality,524 2 32 3 010,20611,33265,17251,16014,107.72
DANG,Babai Gaunpalika,524 5 56 4 001,51005,27469,12529,14940,83.86
PARSA,Pokhariya Municipality,524 2 34 3 001,20809,32885,16859,16026,105.2
MAHOTTARI,Ram Gopalpur Municipality,524 2 18 3 005,20408,30412,14767,15645,94.39
SYANGJA,Chapakot Municipality,524 4 41 3 005,40908,26006,11030,14976,73.65
BHOJPUR,Bhojpur Municipality,524 1 10 3 002,10604,27204,12684,14520,87.36
MAHOTTARI,Matihani Municipality,524 2 18 3 010,20414,31026,15215,15811,96.23
KAVREPALANCHOK,Roshi Gaunpalika,524 3 24 4 004,30911,28746,13531,15215,88.93
BAGLUNG,Kathekhola Gaunpalika,524 4 43 4 005,41102,26083,11057,15026,73.59
ROLPA,Subarnabati Gaunpalika,524 5 54 4 001,50204,28213,12715,15498,82.04
ROLPA,Runtigadhi Gaunpalika,524 5 54 4 009,50208,27929,12453,15476,80.47
SAPTARI,Tilathi Koiladi Gaunpalika,524 2 15 4 009,20117,31735,16184,15551,104.07
ARGHAKHANCHI,Chhatradev Gaunpalika,524 5 50 4 002,50501,25335,10371,14964,69.31
BARA,Pacharauta Municipality,524 2 33 3 004,20713,34173,17538,16635,105.43
SINDHUPALCHOK,Indrawoti Gaunpalika,524 3 23 4 005,30206,28517,13376,15141,88.34
KHOTANG,Halesi Tuwachung Municipality,524 1 12 3 001,10504,29532,13993,15539,90.05
ARGHAKHANCHI,Panini Gaunpalika,524 5 50 4 003,50505,26424,11144,15280,72.93
PARSA,Sakhuwa Prasauni Gaunpalika,524 2 34 4 004,20805,33048,16798,16250,103.37
MAKWANPUR,Bagmati Gaunpalika,524 3 31 4 008,20503,30495,14635,15860,92.28
PYUTHAN,Jhimaruk Gaunpalika,524 5 55 4 003,50303,27931,12117,15814,76.62
SUNSARI,Barju Gaunpalika,524 1 06 4 006,11312,31178,15726,15452,101.77
RAMECHHAP,Ramechhap Municipality,524 3 21 3 002,31004,28612,12879,15733,81.86
SARLAHI,Chandranagar Gaunpalika,524 2 19 4 002,20510,33328,16994,16334,104.04
MAHOTTARI,Aurahi Municipality,524 2 18 3 003,20216,31851,15781,16070,98.2
MORANG,Miklajung Gaunpalika,524 1 05 4 002,10908,28708,13158,15550,84.62
DHADING,Benighat Rorang Gaunpalika,524 3 30 4 008,30409,31475,15660,15815,99.02
JHAPA,Haldibari Gaunpalika,524 1 04 4 006,11113,28933,13320,15613,85.31
DHANUSA,Bideha Municipality,524 2 17 3 010,20313,32266,16013,16253,98.52
GORKHA,Shahid Lakhan Gaunpalika,524 4 36 4 008,40110,27555,12065,15490,77.89
BAITADI,Patam Municipality,524 7 74 3 004,70409,30435,13991,16444,85.08
RAUTAHAT,Gaur Municipality,524 2 32 3 015,20617,34937,18290,16647,109.87
SIRAHA,Karjanha Municipality,524 2 16 3 001,20205,30967,14770,16197,91.19
LAMJUNG,Sundarbazar Municipality,524 4 37 3 003,40606,26864,11769,15095,77.97
OKHALDHUNGA,Siddhicharan Municipality,524 1 13 3 001,10402,27995,12625,15370,82.14
RAUTAHAT,Madhav Narayan Municipality,524 2 32 3 011,20607,35175,18253,16922,107.87
UDAYAPUR,Udayapurgadhi Gaunpalika,524 1 14 4 003,11408,30731,14501,16230,89.35
MAHOTTARI,Samsi Gaunpalika,524 2 18 4 002,20409,33791,16739,17052,98.16
PYUTHAN,Naubahini Gaunpalika,524 5 55 4 001,50302,30292,13620,16672,81.69
BAJHANG,Bungal Municipality,524 7 67 3 001,70202,33224,16216,17008,95.34
KAVREPALANCHOK,Namobuddha Municipality,524 3 24 3 006,30908,29519,13604,15915,85.48
SURKHET,Lekabeshi Municipality,524 6 59 3 004,61003,30295,14122,16173,87.32
DHADING,Dhunibenshi Municipality,524 3 30 3 002,30413,31029,15197,15832,95.99
KAILALI,Bardagoriya Gaunpalika,524 7 71 4 005,70806,32683,15653,17030,91.91
BANKE,Narainapur Gaunpalika,524 5 57 4 006,51108,34942,17978,16964,105.98
DHANUSA,Mithila Bihari Municipality,524 2 17 3 005,20307,33556,16734,16822,99.48
ARGHAKHANCHI,Malarani Gaunpalika,524 5 50 4 001,50502,28044,11869,16175,73.38
SURKHET,Panchapuri Municipality,524 6 59 3 001,61008,32231,15422,16809,91.75
RUPANDEHI,Om Satiya Gaunpalika,524 5 48 4 006,50809,34191,16849,17342,97.16
SARLAHI,Haripurwa Municipality,524 2 19 3 010,20507,36042,18577,17465,106.37
RUKUM,Aathabisakot Municipality,524 6 52 3 001,60605,33601,16623,16978,97.91
RAUTAHAT,Phatuwa Bijayapur Municipality,524 2 32 3 003,20603,36308,18455,17853,103.37
SALYAN,Bagachour Municipality,524 6 53 3 002,60905,34118,16526,17592,93.94
BHOJPUR,Shadananda Municipality,524 1 10 3 001,10601,31606,14925,16681,89.47
BAGLUNG,Badigad Gaunpalika,524 4 43 4 003,41107,30906,13591,17315,78.49
SUNSARI,Dewangunj Gaunpalika,524 1 06 4 005,11311,35073,17863,17210,103.79
MORANG,Kerabari Gaunpalika,524 1 05 4 001,11203,30431,13811,16620,83.1
RAUTAHAT,Paroha Municipality,524 2 32 3 012,20612,37453,19209,18244,105.29
JAJARKOT,Bheri Malika Municipality,524 6 60 3 002,60706,33515,16458,17057,96.49
KAVREPALANCHOK,Dhulikhel Municipality,524 3 24 3 003,30905,32162,15484,16678,92.84
KAPILBASTU,Bijayanagar Gaunpalika,524 5 49 4 001,50904,36937,18831,18106,104
DHADING,Thakre Gaunpalika,524 3 30 4 011,30412,32914,16053,16861,95.21
RUPANDEHI,Sammarimai Gaunpalika,524 5 48 4 009,50815,38305,19535,18770,104.08
SANKHUWASABHA,Khandabari Municipality,524 1 09 3 001,10206,31177,14710,16467,89.33
NAWALPARASI,Palhinandan Gaunpalika,524 5 76 4 001,50704,35429,17311,18118,95.55
RUPANDEHI,Marchawari Gaunpalika,524 5 48 4 010,50816,38776,20039,18737,106.95
JAJARKOT,Chhedagad Municipality,524 6 60 3 001,60704,35295,17354,17941,96.73
DHANUSA,Nagarain Municipality,524 2 17 3 009,20317,35583,17850,17733,100.66
ILAM,Mai Municipality,524 1 03 3 004,11008,32576,15551,17025,91.34
RUPANDEHI,Suddhodhan Gaunpalika,524 5 48 4 002,50806,34638,16652,17986,92.58
DADELDHURA,Parashuram Municipality,524 7 73 3 001,70505,34983,16794,18189,92.33
RUPANDEHI,Rohini Gaunpalika,524 5 48 4 007,50810,37175,18645,18530,100.62
ILAM,Deumai Municipality,524 1 03 3 001,11004,32927,15841,17086,92.71
ACHHAM,Mangalsen Municipality,524 7 69 3 002,70706,32507,14876,17631,84.37
JHAPA,Gauriganj Gaunpalika,524 1 04 4 003,11109,33034,15938,17096,93.23
MAHOTTARI,Pipara Gaunpalika,524 2 18 4 005,20413,35524,17725,17799,99.58
RAUTAHAT,Katahariya Municipality,524 2 32 3 004,20604,38412,19843,18569,106.86
BARDIYA,Geruwa Gaunpalika,524 5 58 4 001,51204,34871,16434,18437,89.14
PARSA,Bahudarmai Municipality,524 2 34 3 002,20808,39673,20734,18939,109.48
NAWALPARASI,Susta Gaunpalika,524 5 76 4 004,50707,35890,17455,18435,94.68
KAVREPALANCHOK,Mandan Deupur Municipality,524 3 24 3 001,30903,32659,15320,17339,88.36
KAPILBASTU,Yasodhara Gaunpalika,524 5 49 4 002,50908,38952,19694,19258,102.26
BANKE,Duduwa Gaunpalika,524 5 57 4 004,51107,37460,19277,18183,106.02
RUKUM,Musikot Municipality,524 6 52 3 003,50404,32939,15416,17523,87.98
MORANG,Gramthan Gaunpalika,524 1 05 4 005,11212,32717,15685,17032,92.09
SUNSARI,Gadhi Gaunpalika,524 1 06 4 003,11308,34852,16931,17921,94.48
JHAPA,Jhapa Gaunpalika,524 1 04 4 004,11110,34601,16703,17898,93.32
ACHHAM,Sanphebagar Municipality,524 7 69 3 001,70704,33788,15484,18304,84.59
KAILALI,Joshipur Gaunpalika,524 7 71 4 004,70809,36459,17834,18625,95.75
MORANG,Letang Municipality,524 1 05 3 001,11202,32053,14350,17703,81.06
DOTI,Shikhar Municipality,524 7 70 3 001,70604,31801,13420,18381,73.01
NAWALPARASI,Binayi Tribeni Gaunpalika,524 4 47 4 004,40808,32943,14774,18169,81.31
PYUTHAN,Sworgadwari Municipality,524 5 55 3 001,50305,30940,12785,18155,70.42
BANKE,Janaki Gaunpalika,524 5 57 4 003,70808,37839,19433,18406,105.58
ROLPA,Rolpa Municipality,524 5 54 3 001,50207,32759,14744,18015,81.84
SAPTARI,Shambhunath Municipality,524 2 15 3 003,20105,35213,16776,18437,90.99
RUPANDEHI,Kanchan Gaunpalika,524 5 48 4 001,50804,33072,14865,18207,81.64
SARLAHI,Haripur Municipality,524 2 19 3 005,20505,37351,18567,18784,98.84
JHAPA,Barhadashi Gaunpalika,524 1 04 4 005,11111,33653,15710,17943,87.56
DOTI,Dipayal Silgadhi Municipality,524 7 70 3 002,70605,32941,15007,17934,83.68
SALYAN,Banagad Kupinde Municipality,524 6 53 3 001,60903,36052,17382,18670,93.1
MAHOTTARI,Sonama Gaunpalika,524 2 18 4 001,20403,38747,19637,19110,102.76
PARSA,Parsagadhi Municipality,524 2 34 3 003,20806,38607,19560,19047,102.69
SALYAN,Sharada Municipality,524 6 53 3 003,60907,33730,15661,18069,86.67
BARA,Nijagadh Municipality,524 2 33 3 001,20701,35335,17026,18309,92.99
TANAHU,Bhimad Municipality,524 4 40 3 004,40705,31362,13360,18002,74.21
RUPANDEHI,Kotahimai Gaunpalika,524 5 48 4 008,50814,41006,21074,19932,105.73
GULMI,Musikot Municipality,524 5 51 3 001,50404,32802,14209,18593,76.42
DHANUSA,Ganeshman Charnath Municipality,524 2 17 3 002,20301,36338,17656,18682,94.51
NAWALPARASI,Sarawal Gaunpalika,524 5 76 4 002,50705,37418,18327,19091,96
SIRAHA,Sukhipur Municipality,524 2 16 3 007,20210,36883,17880,19003,94.09
RAUTAHAT,Gadhimai Municipality,524 2 32 3 009,20606,40410,20705,19705,105.07
BAGLUNG,Jaimuni Municipality,524 4 43 3 004,41110,32046,13676,18370,74.45
SINDHULI,Tinpatan Gaunpalika,524 3 20 4 006,31103,36405,17376,19029,91.31
BAITADI,Dasharathchand Municipality,524 7 74 3 001,70405,34575,15714,18861,83.31
DOLAKHA,Bhimeshwor Municipality,524 3 22 3 001,30109,32486,14980,17506,85.57
RAUTAHAT,Ishanath Municipality,524 2 32 3 013,20618,41435,20868,20567,101.46
ARGHAKHANCHI,Bhumikasthan Municipality,524 5 50 3 001,50503,32640,13935,18705,74.5
RAUTAHAT,Rajpur Municipality,524 2 32 3 014,20613,41078,20324,20754,97.93
BAGLUNG,Galkot Municipality,524 4 43 3 002,41108,33097,14273,18824,75.82
BAITADI,Puchaundi Municipality,524 7 74 3 002,70403,39174,19023,20151,94.4
GULMI,Resunga Municipality,524 5 51 3 002,50409,32548,14354,18194,78.89
RUPANDEHI,Siyari Gaunpalika,524 5 48 4 004,50807,38466,18549,19917,93.13
DHANUSA,Hansapur Municipality,524 2 17 3 007,20308,38216,18402,19814,92.87
DHANUSA,Kamala Municipality,524 2 17 3 011,20311,38624,18731,19893,94.16
MYAGDI,Beni Municipality,524 4 44 3 001,40406,33498,15002,18496,81.11
RAUTAHAT,Brindaban Municipality,524 2 32 3 005,20605,42735,21811,20924,104.24
DANG,Gadhawa Gaunpalika,524 5 56 4 006,51009,38592,18489,20103,91.97
SARLAHI,Kabilashi Municipality,524 2 19 3 007,20511,42336,21791,20545,106.06
SUNSARI,Bhokraha Gaunpalika,524 1 06 4 002,11304,40509,19854,20655,96.12
SUNSARI,Harinagara Gaunpalika,524 1 06 4 004,11310,40846,20139,20707,97.26
MORANG,Katahari Gaunpalika,524 1 05 4 006,11215,39775,20199,19576,103.18
MAKWANPUR,Manahari Gaunpalika,524 3 31 4 001,31205,38399,18520,19879,93.16
MORANG,Dhanapalthan Gaunpalika,524 1 05 4 008,11216,39394,19459,19935,97.61
MAKWANPUR,Bakaiya Gaunpalika,524 3 31 4 007,31209,39620,19129,20491,93.35
PALPA,Rampur Municipality,524 5 46 3 002,50601,35396,15438,19958,77.35
MAHOTTARI,Loharpatti Municipality,524 2 18 3 008,20406,39883,18949,20934,90.52
DHANUSA,Chhireshwornath Municipality,524 2 17 3 003,20305,41793,21141,20652,102.37
KANCHANPUR,Mahakali Municipality,524 7 72 3 001,70303,39253,18130,21123,85.83
KAVREPALANCHOK,Panchkhal Municipality,524 3 24 3 004,30906,37997,17943,20054,89.47
SARLAHI,Bagmati Municipality,524 2 19 3 001,20503,40399,19593,20806,94.17
KAPILBASTU,Shuddhodhan Gaunpalika,524 5 49 4 004,50806,45201,22733,22468,101.18
MORANG,Jahada Gaunpalika,524 1 05 4 007,11217,41819,21118,20701,102.01
DHANKUTA,Dhankuta Municipality,524 1 07 3 003,10704,36619,17167,19452,88.25
NUWAKOT,Belkotgadhi Municipality,524 3 28 3 002,30508,40698,19602,21096,92.92
MORANG,Kanepokhari Gaunpalika,524 1 05 4 003,11206,38033,17487,20546,85.11
SARLAHI,Balara Municipality,524 2 19 3 011,20516,45194,23647,21547,109.75
DANG,Rapti Gaunpalika,524 5 56 4 007,31301,40764,19463,21301,91.37
MAHOTTARI,Balawa Municipality,524 2 18 3 007,20407,42341,20632,21709,95.04
JHAPA,Kachanakawal Gaunpalika,524 1 04 4 007,11115,39538,18707,20831,89.8
SYANGJA,Galyang Municipality,524 4 41 3 003,40910,37809,16475,21334,77.22
CHITAWAN,Madi Municipality,524 3 35 3 005,10209,37683,16876,20807,81.11
DAILEKH,Dullu Municipality,524 6 61 3 003,60607,41540,19881,21659,91.79
NAWALPARASI,Pratapapur Gaunpalika,524 5 76 4 003,50706,45241,22787,22454,101.48
SAPTARI,Bode Barsain Municipality,524 2 15 3 006,20109,43229,21319,21910,97.3
RUPANDEHI,Mayadevi Gaunpalika,524 5 48 4 005,50812,47156,23778,23378,101.71
SUNSARI,Koshi Gaunpalika,524 1 06 4 001,11303,43626,21954,21672,101.3
SAPTARI,Dakneshwori Municipality,524 2 15 3 007,20110,42754,20687,22067,93.75
DHANUSA,Mithila Municipality,524 2 17 3 001,20303,45164,22978,22186,103.57
MORANG,Budhiganga Gaunpalika,524 1 05 4 004,11213,41586,20717,20869,99.27
KAPILBASTU,Mayadevi Gaunpalika,524 5 49 4 003,50812,48218,24198,24020,100.74
PYUTHAN,Pyuthan Municipality,524 5 55 3 002,50304,38449,16813,21636,77.71
RAUTAHAT,Gujara Municipality,524 2 32 3 001,20602,46592,23380,23212,100.72
SARLAHI,Malangawa Municipality,524 2 19 3 009,20520,46516,23821,22695,104.96
BARA,Simroungadh Municipality,524 2 33 3 005,20712,48570,25015,23555,106.2
MAKWANPUR,Thaha Municipality,524 3 31 3 001,31202,41623,19811,21812,90.83
BARA,Kolhabi Municipality,524 2 33 3 002,20702,44035,21305,22730,93.73
JHAPA,Kankai Municipality,524 1 04 3 003,11104,40141,18536,21605,85.79
SARLAHI,Godaita Municipality,524 2 19 3 008,20517,47687,24548,23139,106.09
SURKHET,Bheriganga Municipality,524 6 59 3 002,61005,41407,19145,22262,86
RUPANDEHI,Gaidahawa Gaunpalika,524 5 48 4 003,50805,47565,23730,23835,99.56
SARLAHI,Hariwan Municipality,524 2 19 3 002,20502,43924,21395,22529,94.97
SAPTARI,Hanumannagar Kankalini Municipality,524 2 15 3 009,20116,45734,22725,23009,98.77
CHITAWAN,Kalika Municipality,524 3 35 3 001,30304,42493,20218,22275,90.77
JHAPA,Buddhashanti Gaunpalika,524 1 04 4 002,11102,41585,19642,21943,89.51
GORKHA,Palungtar Municipality,524 4 36 3 001,40108,38174,16604,21570,76.98
UDAYAPUR,Belaka Municipality,524 1 14 3 004,11401,42386,19605,22781,86.06
RAUTAHAT,Garuda Municipality,524 2 32 3 008,20608,50481,25998,24483,106.19
SAPTARI,Surunga Municipality,524 2 15 3 001,20107,44222,20787,23435,88.7
LAMJUNG,Bensi Shahar Municipality,524 4 37 3 002,40605,39356,17670,21686,81.48
PARBAT,Kushma Municipality,524 4 42 3 001,41003,39600,17739,21861,81.14
BARDIYA,Thakurbaba Municipality,524 5 58 3 003,51203,44316,20764,23552,88.16
DHANUSA,Dhanushadham Municipality,524 2 17 3 004,20302,45585,22082,23503,93.95
NAWALPARASI,Devchuli Municipality,524 4 47 3 003,40805,42603,19603,23000,85.23
KAILALI,Kailari Gaunpalika,524 7 71 4 002,70812,47987,23491,24496,95.9
ARGHAKHANCHI,Shitaganga Municipality,524 5 50 3 003,50506,43373,19969,23404,85.32
SAPTARI,Khadak Municipality,524 2 15 3 002,20106,45368,21308,24060,88.56
SIRAHA,Dhangadhimai Municipality,524 2 16 3 004,20202,47449,23430,24019,97.55
DHANUSA,Shahidnagar Municipality,524 2 17 3 008,20310,47422,23148,24274,95.36
BARA,Mahagadhimai Municipality,524 2 33 3 003,20714,52336,26818,25518,105.09
MAHOTTARI,Bhangaha Municipality,524 2 18 3 004,20405,46757,21990,24767,88.79
MAHOTTARI,Manara Shisawa Municipality,524 2 18 3 006,20410,49692,24856,24836,100.08
ARGHAKHANCHI,Sandhikharka Municipality,524 5 50 3 002,50504,41079,18262,22817,80.04
SURKHET,Gurbhakot Municipality,524 6 59 3 005,61004,43765,19882,23883,83.25
SINDHUPALCHOK,Melanchi Municipality,524 3 23 3 001,30205,45343,21729,23614,92.02
KANCHANPUR,Shuklaphanta Municipality,524 7 72 3 004,70902,46834,21925,24909,88.02
DANG,Lamahi Municipality,524 5 56 3 001,51007,47655,22898,24757,92.49
SIRAHA,Mirchaiya Municipality,524 2 16 3 002,20204,48911,24047,24864,96.71
JHAPA,Kamal Gaunpalika,524 1 04 4 001,11106,44365,20296,24069,84.32
BARDIYA,Madhuwan Municipality,524 5 58 3 002,51206,46437,21503,24934,86.24
KAILALI,Janaki Gaunpalika,524 7 71 4 006,51105,48540,22956,25584,89.73
KAPILBASTU,Maharajganj Municipality,524 5 49 3 005,50906,54800,28122,26678,105.41
RAMECHHAP,Manthali  Municipality,524 3 21 3 001,31005,45416,20750,24666,84.12
KAILALI,Bhajani Municipality,524 7 71 3 004,70811,51845,25716,26129,98.42
KAVREPALANCHOK,Panauti Municipality,524 3 24 3 005,30909,46595,21808,24787,87.98
KANCHANPUR,Bedkot Municipality,524 7 72 3 003,70903,49479,23492,25987,90.4
KHOTANG,Rupakot Majhuwagadhi Municipality,524 1 12 3 002,10505,46903,21599,25304,85.36
SIRAHA,Kalyanpur Municipality,524 2 16 3 006,20206,49290,23047,26243,87.82
BARDIYA,Badhaiyatal Gaunpalika,524 5 58 4 002,51208,47868,22296,25572,87.19
SINDHUPALCHOK,Choutara Sangachowkgadhi Municipality,524 3 23 3 002,30207,46497,21272,25225,84.33
ILAM,Illam Municipality,524 1 03 3 002,11003,48536,23461,25075,93.56
MORANG,Sunwarshi Municipality,524 1 05 3 007,11210,50758,24957,25801,96.73
KANCHANPUR,Belouri Municipality,524 7 72 4 001,70909,53544,25457,28087,90.64
SIRAHA,Golbazar Municipality,524 2 16 3 003,20203,52137,25394,26743,94.96
UDAYAPUR,Chaudandigadhi Municipality,524 1 14 3 003,11402,48574,22082,26492,83.35
PANCHTHAR,Phidim Municipality,524 1 02 3 001,10904,49201,23167,26034,88.99
SYANGJA,Putalibazar Municipality,524 4 41 3 001,40901,44876,19638,25238,77.81
DHANUSA,Sabaila Municipality,524 2 17 3 006,20309,52389,25090,27299,91.91
SAPTARI,Kanchanrup Municipality,524 2 15 3 005,20102,53288,25953,27335,94.94
BANKE,Khajura Gaunpalika,524 5 57 4 001,51104,50961,23504,27457,85.6
MORANG,Rangeli Municipality,524 1 05 3 006,11211,52013,25081,26932,93.13
TANAHU,Bhanu Municipality,524 4 40 3 003,40701,45792,19661,26131,75.24
KAPILBASTU,Krishnanagar Municipality,524 5 49 3 004,50905,62360,32299,30061,107.44
KANCHANPUR,Punarbas Municipality,524 7 72 3 007,70907,53633,24907,28726,86.71
MAHOTTARI,Jaleshwor Municipality,524 2 18 3 009,20415,57549,28696,28853,99.46
SUNSARI,Ramdhuni Municipality,524 1 06 3 002,11305,51722,23984,27738,86.47
KAILALI,Gauriganga Municipality,524 7 71 3 002,70804,55314,26121,29193,89.48
NAWALPARASI,Ramgram Municipality,524 5 76 3 003,50703,56845,27852,28993,96.06
TANAHU,Shuklagandaki Municipality,524 4 40 3 001,40704,48456,21292,27164,78.38
KANCHANPUR,Krishnapur Municipality,524 7 72 3 005,70901,56643,27059,29584,91.46
SUNSARI,Duhabi Municipality,524 1 06 3 004,11307,56216,28107,28109,99.99
RUPANDEHI,Devdaha Municipality,524 5 48 3 002,50801,53523,24841,28682,86.61
BANKE,Baijanath Gaunpalika,524 5 57 4 002,51103,54418,25372,29046,87.35
JHAPA,Gauradaha Municipality,524 1 04 3 006,11108,53033,24936,28097,88.75
KAVREPALANCHOK,Banepa Municipality,524 3 24 3 002,30904,55628,27305,28323,96.41
GORKHA,Gorkha Municipality,524 4 36 3 002,40109,49272,21959,27313,80.4
BHAKTAPUR,Changunarayan Municipality,524 3 26 3 002,30701,55430,26992,28438,94.92
BARDIYA,Bansgadhi Municipality,524 5 58 3 006,51201,55875,26302,29573,88.94
SYANGJA,Walling Municipality,524 4 41 3 004,40909,51243,22580,28663,78.78
PALPA,Tansen Municipality,524 5 46 3 001,50605,50405,22816,27589,82.7
UDAYAPUR,Katari Municipality,524 1 14 3 001,11407,56146,26582,29564,89.91
SARLAHI,Ishworpur Municipality,524 2 19 3 006,20506,59986,29643,30343,97.69
MORANG,Ratuwamai Municipality,524 1 05 3 008,11209,55380,26335,29045,90.67
BARDIYA,Rajapur Municipality,524 5 58 3 001,51205,59553,28921,30632,94.41
NUWAKOT,Bidur Municipality,524 3 28 3 001,30504,54351,25228,29123,86.63
NAWALPARASI,Madhya Bindu Municipality,524 4 47 3 001,40807,54140,24057,30083,79.97
ILAM,Suryodaya Municipality,524 1 03 3 003,11009,56707,27867,28840,96.63
BANKE,Rapti Sonari Gaunpalika,524 5 57 4 005,51101,59946,28617,31329,91.34
MORANG,Urlabari Municipality,524 1 05 3 005,11208,54696,25148,29548,85.11
NAWALPARASI,Sunawal Municipality,524 5 76 3 001,50702,55790,25585,30205,84.7
CHITAWAN,Khairahani Municipality,524 3 35 3 003,31306,56094,26075,30019,86.86
CHITAWAN,Rapti Municipality,524 3 35 3 004,31301,58107,27729,30378,91.28
RUPANDEHI,Sainamaina Municipality,524 5 48 3 001,50803,55822,25528,30294,84.27
SARLAHI,Lalbandi Municipality,524 2 19 3 003,20501,59395,28795,30600,94.1
NAWALPARASI,Gaidakot Municipality,524 4 47 3 004,40801,58841,28209,30632,92.09
RUPANDEHI,Siddharthanagar Municipality,524 5 48 3 005,50811,63483,31673,31810,99.57
KATHMANDU,Kageshwori Manahara Municipality,524 3 27 3 006,30602,60237,30233,30004,100.76
MAHOTTARI,Gaushala Municipality,524 2 18 3 002,20402,66677,33751,32926,102.51
KAPILBASTU,Shivaraj Municipality,524 5 49 3 001,50903,66781,33161,33620,98.63
KAPILBASTU,Buddhabhumi Municipality,524 5 49 3 002,50902,64949,31583,33366,94.66
JHAPA,Arjundhara Municipality,524 1 04 3 004,11103,60205,28425,31780,89.44
SUNSARI,Inaruwa Municipality,524 1 06 3 003,11309,63593,31195,32398,96.29
MAHOTTARI,Bardibas Municipality,524 2 18 3 001,20401,64212,31349,32863,95.39
DHADING,Nilkhantha Municipality,524 3 30 3 001,30406,58515,26510,32005,82.83
LALITPUR,Mahalaxmi Municipality,524 3 25 3 002,10701,62172,31071,31101,99.9
RUPANDEHI,Lumbini Sanskritik Municipality,524 5 48 3 004,50813,72497,36137,36360,99.39
BARDIYA,Gulariya Municipality,524 5 58 3 004,51207,66679,33427,33252,100.53
SARLAHI,Barahathawa Municipality,524 2 19 3 004,20504,69822,35206,34616,101.7
SAPTARI,Rajbiraj Municipality,524 2 15 3 008,20113,68396,35092,33304,105.37
NAWALPARASI,Bardaghat Municipality,524 5 76 3 002,50701,61472,28137,33335,84.41
MORANG,Pathari Shanishchare Municipality,524 1 05 3 004,11207,61132,27756,33376,83.16
BAGLUNG,Baglung Municipality,524 4 43 3 003,41101,57823,25548,32275,79.16
SINDHULI,Dudhouli Municipality,524 3 20 3 002,31101,65302,31004,34298,90.4
NAWALPARASI,Kawasoti Municipality,524 4 47 3 002,40806,62421,28616,33805,84.65
SINDHULI,Kamalamai Municipality,524 3 20 3 001,31105,64386,30462,33924,89.79
KATHMANDU,Kirtipur Municipality,524 3 27 3 009,30609,65602,36476,29126,125.24
BARDIYA,Barbardiya Municipality,524 5 58 3 005,51202,68012,32673,35339,92.46
JHAPA,Shivasatakshi Municipality,524 1 04 3 002,11105,64596,29715,34881,85.19
RAUTAHAT,Chandrapur Municipality,524 2 32 3 002,20601,72059,35858,36201,99.05
JHAPA,Bhadrapur Municipality,524 1 04 3 008,11114,65533,30958,34575,89.54
KATHMANDU,Nagarjun Municipality,524 3 27 3 005,30607,67420,34064,33356,102.12
KAPILBASTU,Kapilbastu Municipality,524 5 49 3 006,50907,76394,38085,38309,99.42
MORANG,Belbari Municipality,524 1 05 3 003,11205,65892,30111,35781,84.15
KAILALI,Ghodaghodi Municipality,524 7 71 3 003,70805,75586,36852,38734,95.14
BANKE,Kohalpur Municipality,524 5 57 3 001,51102,70647,34112,36535,93.37
CHITAWAN,Ratnanagar Municipality,524 3 35 3 002,31305,69851,33256,36595,90.88
KAILALI,Lamki Chuha Municipality,524 7 71 3 006,70807,75425,35408,40017,88.48
KAILALI,Tikapur Municipality,524 7 71 3 005,70810,76084,36245,39839,90.98
KAPILBASTU,Banganga Municipality,524 5 49 3 003,50901,75242,34933,40309,86.66
KAILALI,Godawari Municipality,524 7 71 3 001,30803,78018,36642,41376,88.56
TANAHU,Byas Municipality,524 4 40 3 002,40702,70335,31260,39075,80
JHAPA,Damak Municipality,524 1 04 3 001,11107,75102,35438,39664,89.35
LALITPUR,Godawari Municipality,524 3 25 3 001,30803,78301,38282,40019,95.66
BHAKTAPUR,Suryabinayak Municipality,524 3 26 3 004,30704,78490,38899,39591,98.25
SIRAHA,Siraha Municipality,524 2 16 3 008,20217,82531,39706,42825,92.72
BHAKTAPUR,Bhaktapur Municipality,524 3 26 3 003,30702,81748,41081,40667,101.02
SUNSARI,Baraha Municipality,524 1 06 3 001,11302,77407,35561,41846,84.98
KATHMANDU,Tarakeshwor Municipality,524 3 27 3 001,30507,81443,41376,40067,103.27
BHAKTAPUR,Madhyapur Thimi Municipality,524 3 26 3 001,30703,83036,42723,40313,105.98
JHAPA,Birtamod Municipality,524 1 04 3 007,11112,81878,39748,42130,94.35
MORANG,Sundarharaicha Municipality,524 1 05 3 002,11204,80518,37694,42824,88.02
KATHMANDU,Chandragiri Municipality,524 3 27 3 008,30610,85198,42881,42317,101.33
SIRAHA,Lahan Municipality,524 2 16 3 005,20201,91766,45515,46251,98.41
UDAYAPUR,Triyuga Municipality,524 1 14 3 002,11403,87557,41221,46336,88.96
KATHMANDU,Tokha Municipality,524 3 27 3 002,30605,99032,50709,48323,104.94
KANCHANPUR,Bhimdatta Municipality,524 7 72 3 002,70904,104599,51087,53512,95.47
RUPANDEHI,Tilottama Municipality,524 5 48 3 003,50808,100149,47178,52971,89.06
SURKHET,Birendranagar Municipality,524 6 59 3 003,61006,100458,48771,51687,94.36
BARA,Kalaiya Sub-Metropolitian City,524 2 33 2 002,20708,123024,63648,59376,107.19
BARA,Jitpur Simara Sub-Metropolitian City,524 2 33 2 001,20703,117094,58725,58369,100.61
KATHMANDU,Budhanilkhantha Municipality,524 3 27 3 003,30604,107918,54185,53733,100.84
KATHMANDU,Gokarneshwor Municipality,524 3 27 3 004,30603,107351,53725,53626,100.18
JHAPA,Mechinagar Municipality,524 1 04 3 005,11101,111737,52996,58741,90.22
BANKE,Nepalganj Sub-Metropolitian City,524 5 57 2 001,51106,138951,70877,68074,104.12
KAILALI,Dhangadhi Sub-Metropolitian City,524 7 71 2 001,70813,147741,73462,74279,98.9
RUPANDEHI,Butwal Sub-Metropolitian City,524 5 48 2 001,50802,138742,68288,70454,96.93
SUNSARI,Dharan Sub-Metropolitian City,524 1 06 2 001,11301,137705,64671,73034,88.55
DANG,Tulsipur Sub-Metropolitian City,524 5 56 2 001,51003,141528,66675,74853,89.07
SUNSARI,Itahari Sub-Metropolitian City,524 1 06 2 002,11306,140517,66566,73951,90.01
DHANUSA,Janakpur Sub-Metropolitian City,524 2 17 2 001,20315,162172,84276,77896,108.19
MAKWANPUR,Hetauda Sub-Metropolitian City,524 3 31 2 001,31206,152875,74964,77911,96.22
DANG,Ghorahi Sub-Metropolitian City,524 5 56 2 002,51002,156164,72329,83835,86.28
PARSA,Birgunj Metropolitian City,524 2 34 1 001,20807,240922,127227,113695,111.9
MORANG,Biratnagar Metropolitian City,524 1 05 1 001,11214,214663,108827,105836,102.83
LALITPUR,Lalitpur Metropolitian City,524 3 25 1 001,30801,284922,145924,138998,104.98
CHITAWAN,Bharatpur Metropolitian City,524 3 35 1 001,30702,280502,134001,146501,91.47
KASKI,Pokhara Lekhnath Metropolitian City,524 4 39 1 001,40504,402995,192977,210018,91.89
KATHMANDU,Kathmandu Metropolitian City,524 3 27 1 001,30601,975453,511841,463612,110.4
